1111111111
1PCCCCCC01
1CCC001001
1CCC1CC001
1CCC111E11
1CCC0C1111
1111111111