1111111111
1PCCCCCC01
1CCC001001
1CCC1CCCC1
1CCC1111C1
1CCC0C10E1
1111111111