1111111111111
1000000000001
10000000000E1
1000000000001
100000P111111
1111111111111