111111111
1P0000001
111000011
10E1000C1
111111111