1111111111
00000C0001
1P000000E1
1111111111