111111111111111111111111
100000000001100000000001
100000000001100000000001
100011110001111111110001
100011110001111111100011
100011110001111110001111
100011110001111000111111
100P00C0E001000000000001
100000000001000000000001
111111111111111111111111