1111111111111111111111
1C10C01011101110101111
10101C1111111111111011
1C0C000P0000C000C01111
1011101011111010111C11
1111111011101010001011
1C00111011111010111C11
1C1C101011111110101011
111C111010001010111011
1000C00C1010100C0000E1
1111111111111111111111