11111111
100001C1
1P0000E1
1C000001
11111111