111111111111111
1000000000000E1
100000000000001
100000000000001
100000000P00001
100C00000000001
1000000000P0001
111111111111111